0:
1:./assets/texture/world/bricks.png
000000000000000000000000000000000000000000000000
000000000000000000000000000000000000000000000000
000000000000000000000000000000000000000000000000
000000000000000000000000000000000000000000000000
000000000000000000000000000000000011100000000000
000000000000000000000000000000000010010000000000
000000000000000000000000000000000011100000000000
000000000000000000000000000000000010010000000000
000000000000000000000000000000000010010000000000
000000000000000000000000000000000010001000000000
000000000000000000000000000000000010001000000000
111111111111111111111111111111111111111111111111
111111111111111111111111111111111111111111111111
111111111111111111111111111111111111111111111111
111111111111111111111111111111111111111111111111